1111111111111111111111111111111111111111111111111111
1E0000000000000C000C00000000000000000000000000000001
1010010100100000101100000001010000000000000000000001
1010010010101010001000000001010000000000000000000001
1P0000000C00C0000000000000000000000000000000000000C1
1010010010101010001001000001010000000000000000000001
1010010010101010001001000001010000000000000000000001
1010010010101010001001000000010000000000000000000001
1010010010101010001001000000010000000000000000000001
1010010010101010001001000000010100000000000000000001
1010010010101010001001000000010100000000000000000001
1010010010101010001001000000010100000000000000000001
1010010010101010001100000001010000000000000000000001
1010010010101010001000000001010000000000000000000001
1010010010101010001001000001010000000000000000000001
1010010010101010001001000001010000000000000000000001
1010010010101010001001000001010000000000000000000001
1010010010101010001001000000010000000000000000000001
1010010010101010001001000000010000000000000000000001
1010010010101010001001000000010100000000000000000001
1010010010101010001001000000010100000000000000000001
1010010010101010001001000000010100000000000000000001
1010010010101010001001000000010100000000000000000001
1010010010101010001001000000010100000000000000000001
1010010010101010001001000000010100000000000000000001
1010010010101010001001000000010100000000000000000001
1010010010101010001001000000010100000000000000000001
1010010010101010001001000000010100000000000000000001
1111111111111111111111111111111111111111111111111111