1111111111111
11E100C001111
1101011111111
101P111000011
1111111111111