1111111111
10E0000001
10C0011001
1P00111011
1111111111